4 4 4 4 4 4 4 4 4 4 4 4 4 4 4 4 4 4 4 4 4 4 4 4 4 4 4 4 4 4 4 4 4 4 4 4 4 4 4 4 4 4 4 4 4 4 4 4 4 4 4 4 4 4 4 4 4 4 4 4 4 4 4 4 4 4 4 4 4 4 4 4 4 4 4 4 4 4 4 4 4 4 4 4 4 4 4 4 4 4 4 4 4 4 4 4 4 4 4 4 
4 4 4 4 4 4 4 4 4 4 4 4 4 4 4 4 4 4 4 4 4 4 4 4 4 4 4 4 4 4 4 4 4 4 4 4 4 4 4 4 4 4 4 4 4 4 4 4 4 4 4 4 4 4 4 4 4 4 4 4 4 4 4 4 4 4 4 4 4 4 4 4 4 4 4 4 4 4 4 4 4 4 4 4 4 4 4 4 4 4 4 4 4 4 4 4 4 4 4 4 
4 4 4 4 4 4 4 4 4 4 4 4 4 4 4 4 4 4 4 4 4 4 4 4 4 4 4 4 4 4 4 4 4 4 4 4 4 4 4 4 4 4 4 4 4 4 4 4 4 4 4 4 4 4 4 4 4 4 4 4 4 4 4 4 4 4 4 4 4 4 4 4 4 4 4 4 4 4 4 4 4 4 4 4 4 4 4 4 4 4 4 4 4 4 4 4 4 4 4 4 
4 4 4 4 4 4 4 4 4 4 4 4 4 4 4 4 4 4 4 4 4 4 4 4 4 4 4 4 4 4 4 4 4 4 4 4 4 4 4 4 4 4 4 4 4 4 4 4 4 4 4 4 4 4 4 4 4 4 4 4 4 4 4 4 4 4 4 4 4 4 4 4 4 4 4 4 4 4 4 4 4 4 4 4 4 4 4 4 4 4 4 4 4 4 4 4 4 4 4 4 
4 4 4 4 4 4 4 4 4 4 4 4 4 4 4 4 4 4 4 4 4 4 4 4 4 4 4 4 4 4 4 4 4 4 4 4 4 4 4 4 4 4 4 4 4 4 4 4 4 4 4 4 4 4 4 4 4 4 4 4 4 4 4 4 4 4 4 4 4 4 4 4 4 4 4 4 4 4 4 4 4 4 4 4 4 4 4 4 4 4 4 4 4 4 4 4 4 4 4 4 
4 4 4 4 4 4 4 3 3 3 3 3 3 3 3 3 3 3 3 3 3 3 3 3 3 3 3 3 3 3 3 3 3 3 3 3 3 3 3 3 3 3 3 3 3 3 3 3 3 3 3 3 3 3 3 3 3 3 3 3 3 3 3 3 3 3 3 3 3 3 3 3 3 3 3 3 3 3 3 3 3 3 3 3 3 3 3 3 3 3 3 3 3 4 4 4 4 4 4 4 
4 4 4 4 4 4 4 3 4 4 4 4 4 4 4 4 4 4 4 4 4 4 4 4 4 4 4 4 4 4 4 4 4 4 4 4 4 4 4 4 4 4 4 4 4 4 4 4 4 4 4 4 4 4 4 4 4 4 4 4 4 4 4 4 4 4 4 4 4 4 4 4 4 4 3 2 2 2 2 2 3 4 4 4 4 4 4 4 4 4 4 4 3 4 4 4 4 4 4 4 
4 4 4 4 4 4 4 3 4 4 4 4 4 4 4 4 4 4 4 4 4 4 4 4 4 4 4 4 4 4 4 4 4 4 4 4 4 4 4 4 4 4 4 4 4 4 4 4 4 4 4 4 4 4 4 4 4 4 4 4 4 4 4 4 4 4 4 4 4 4 4 4 4 4 3 2 2 2 2 2 3 4 4 4 4 4 4 4 4 4 4 4 3 4 4 4 4 4 4 4 
4 4 4 4 4 4 4 3 4 4 1 1 1 1 1 1 1 1 1 1 4 4 4 4 4 4 4 4 4 4 4 4 4 4 4 4 4 4 4 4 4 4 4 4 4 4 4 4 4 4 4 4 4 4 4 4 4 4 4 4 4 4 4 4 4 4 4 4 4 4 4 4 4 4 3 2 2 2 2 2 3 4 4 4 4 4 4 4 4 4 4 4 3 4 4 4 4 4 4 4 
4 4 4 4 4 4 4 3 4 4 1 1 1 1 1 1 1 1 1 1 4 4 4 4 4 4 4 4 4 4 4 4 4 4 4 4 4 4 4 4 4 4 4 4 4 4 4 4 4 4 4 4 4 4 4 4 4 4 4 4 4 4 4 4 4 4 4 4 4 4 4 4 4 4 3 2 2 2 2 2 3 4 4 4 4 4 4 4 4 4 4 4 3 4 4 4 4 4 4 4 
4 4 4 4 4 4 4 3 4 4 1 1 1 1 1 1 1 1 1 1 4 4 4 4 4 4 4 4 4 4 4 4 4 4 4 4 4 4 4 4 4 4 4 4 4 4 4 4 4 4 4 4 4 4 4 4 4 4 4 4 4 4 4 4 4 4 4 4 4 4 4 4 4 4 3 2 2 2 2 2 3 4 4 4 4 4 4 4 4 4 4 4 3 4 4 4 4 4 4 4 
4 4 4 4 4 4 4 3 4 4 1 1 1 1 1 1 1 1 1 1 4 4 4 4 4 4 4 4 4 4 4 4 4 4 4 4 4 4 4 4 4 4 4 4 4 4 4 4 4 4 4 4 4 4 4 4 4 4 4 4 4 4 4 4 4 4 4 4 4 4 4 4 4 4 3 3 3 1 3 3 3 4 4 4 4 4 4 4 4 4 4 4 3 4 4 4 4 4 4 4 
4 4 4 4 4 4 4 3 4 4 1 1 1 1 1 1 1 1 1 1 4 4 4 4 4 4 4 4 4 4 4 4 4 4 4 4 4 4 4 4 4 4 4 4 4 4 4 4 4 4 4 4 4 4 4 4 4 4 0 0 0 0 0 0 0 0 4 4 4 4 4 4 4 4 4 4 4 1 4 4 4 4 4 4 4 4 4 4 4 4 4 4 3 4 4 4 4 4 4 4 
4 4 4 4 4 4 4 3 4 4 1 1 1 3 1 1 3 1 1 1 4 4 4 4 4 4 4 4 4 4 4 4 4 4 4 4 4 4 4 4 4 4 4 4 4 4 4 4 4 4 4 4 4 4 4 4 4 0 0 4 4 4 4 4 4 0 0 4 4 4 4 4 4 4 4 4 4 1 4 4 4 4 4 4 4 4 4 4 4 4 4 4 3 4 4 4 4 4 4 4 
4 4 4 4 4 4 4 3 4 4 4 4 4 4 1 1 4 4 4 4 4 4 4 4 4 4 4 4 4 4 4 4 4 4 4 4 4 4 4 4 4 4 4 4 4 4 3 3 3 3 3 3 3 4 4 4 0 0 0 4 4 4 4 4 4 0 0 4 4 4 4 4 4 4 4 4 4 1 4 4 4 4 4 4 4 4 4 4 4 4 4 4 3 4 4 4 4 4 4 4 
4 4 4 4 4 4 4 3 4 4 4 4 4 4 1 1 4 4 4 4 4 4 4 4 4 4 4 4 4 4 4 4 4 4 4 4 4 4 4 4 4 4 4 4 4 4 3 2 2 2 2 2 3 4 4 4 0 0 4 4 6 6 6 6 4 4 0 4 4 4 4 4 4 4 4 4 4 1 4 4 4 4 4 4 4 4 4 4 4 4 4 4 3 4 4 4 4 4 4 4 
4 4 4 4 4 4 4 3 4 4 4 4 4 4 5 5 4 4 4 4 4 4 4 4 4 4 4 4 4 4 4 4 4 4 4 4 4 4 4 4 4 4 4 4 4 4 3 2 2 2 2 2 3 4 4 4 0 0 4 4 6 6 6 6 4 4 0 4 4 4 4 4 4 4 4 4 4 1 4 4 4 4 4 4 4 4 4 4 4 4 4 4 3 4 4 4 4 4 4 4 
4 4 4 4 4 4 4 3 4 4 4 4 4 4 1 1 4 4 4 4 4 4 4 4 4 4 4 4 4 4 4 4 4 4 4 4 4 4 4 4 4 4 4 4 4 4 3 2 2 2 2 2 3 4 4 4 4 4 4 4 6 6 6 6 4 4 4 4 4 4 4 4 4 1 1 1 1 1 4 4 4 4 4 4 4 4 4 4 4 4 4 4 3 4 4 4 4 4 4 4 
4 4 4 4 4 4 4 3 4 4 4 4 4 4 6 6 4 4 4 4 4 4 4 4 4 4 4 4 4 4 4 4 4 4 4 4 4 4 4 4 4 4 4 4 4 4 3 3 3 2 3 3 3 4 4 4 4 4 4 4 6 6 6 6 4 4 4 4 4 0 4 4 4 1 4 4 4 4 4 4 4 4 4 4 4 4 4 4 4 4 4 4 3 4 4 4 4 4 4 4 
4 4 4 4 4 4 4 3 4 4 4 4 4 4 1 1 4 4 4 4 4 4 4 4 4 4 4 4 4 4 4 4 4 4 4 4 4 4 4 4 4 4 4 4 4 4 4 7 0 1 0 7 4 4 4 4 4 4 4 1 1 1 1 1 1 4 4 0 0 0 4 4 4 1 4 4 4 4 4 4 0 0 4 4 4 4 4 4 4 4 4 4 3 4 4 4 4 4 4 4 
4 4 4 4 4 4 4 3 4 4 4 4 4 4 6 6 4 4 4 4 4 4 4 4 4 4 4 4 4 4 4 4 4 4 4 4 4 4 4 4 4 4 4 4 6 6 4 4 1 0 1 4 4 5 5 4 4 4 4 1 1 1 1 1 1 4 4 0 0 0 4 4 4 1 4 4 4 4 4 4 4 4 4 4 4 4 4 4 4 4 4 4 3 4 4 4 4 4 4 4 
4 4 4 4 4 4 4 3 4 4 4 4 4 4 1 1 4 4 4 4 4 4 4 4 4 4 4 4 4 4 4 4 4 4 4 4 4 4 4 4 4 4 4 4 6 6 4 1 0 1 0 1 4 5 5 4 4 4 4 4 1 1 1 1 4 4 4 0 0 0 4 4 4 1 1 1 1 1 1 1 4 4 4 4 4 4 4 4 4 4 4 4 3 4 4 4 4 4 4 4 
4 4 4 4 4 4 4 3 4 4 4 4 4 4 5 5 4 4 4 4 4 4 4 4 4 4 4 4 4 4 4 4 4 4 4 4 4 4 4 4 4 4 4 4 4 4 4 0 1 0 1 0 4 4 4 4 4 4 4 4 1 1 1 1 4 4 4 0 0 0 4 4 4 4 4 4 4 4 4 1 4 4 4 4 4 4 4 4 4 4 4 4 3 4 4 4 4 4 4 4 
4 4 4 4 4 4 4 3 4 4 4 4 4 4 1 1 4 4 4 4 4 4 4 4 4 4 4 4 4 4 4 3 3 3 3 3 3 3 3 3 3 3 3 3 4 4 4 7 0 1 0 7 4 4 4 4 4 4 4 4 4 1 1 4 4 4 4 4 4 4 4 4 4 4 4 0 4 4 4 1 0 4 4 4 4 4 4 4 4 4 4 4 3 4 4 4 4 4 4 4 
4 4 4 4 4 4 4 3 4 4 4 4 4 4 1 1 4 4 4 4 4 4 4 4 4 4 4 4 4 4 4 3 6 6 6 6 6 6 6 1 5 5 5 3 4 4 4 4 3 1 3 4 4 4 4 4 4 4 4 4 4 1 1 4 4 4 4 4 4 4 4 4 4 4 0 0 4 4 4 1 0 4 4 4 4 4 4 4 4 4 4 4 3 4 4 4 4 4 4 4 
4 4 4 4 4 4 4 3 4 3 1 1 1 1 1 1 1 1 1 1 1 1 3 4 4 4 4 4 4 3 3 3 6 3 3 3 3 3 3 3 3 3 5 3 4 4 4 4 3 1 3 4 6 6 6 4 4 4 4 4 4 1 1 4 4 4 4 4 6 6 6 4 4 0 4 4 4 1 1 1 0 4 4 4 4 4 4 4 4 4 4 4 3 4 4 4 4 4 4 4 
4 4 4 4 4 4 4 3 4 3 1 1 1 1 1 1 1 1 1 1 1 1 3 4 4 4 4 4 4 3 3 3 6 3 4 4 4 4 4 4 4 3 5 3 4 4 4 4 3 1 3 4 6 6 6 4 4 4 4 4 4 1 1 4 4 4 4 4 6 6 6 4 4 4 4 4 4 1 4 4 4 4 4 4 4 4 4 4 4 4 4 4 3 4 4 4 4 4 4 4 
4 4 4 4 4 4 4 3 4 3 1 1 3 4 4 4 4 4 4 3 1 1 3 4 4 1 1 1 1 1 1 1 1 5 5 5 3 4 4 4 4 3 5 3 4 4 4 4 3 1 3 4 6 6 6 4 7 0 0 0 0 1 1 0 0 0 7 4 6 6 6 4 4 4 4 4 4 1 4 4 4 4 4 4 4 4 4 4 4 4 4 4 3 4 4 4 4 4 4 4 
4 4 4 4 4 4 4 3 4 3 1 1 3 4 4 4 4 4 4 3 1 1 1 1 1 1 1 3 3 3 3 3 3 3 3 5 3 4 4 4 4 3 5 3 4 4 1 1 1 1 4 4 4 4 4 4 0 0 0 0 4 1 1 4 0 0 0 4 4 4 4 4 4 4 4 4 4 1 4 4 4 4 4 4 4 4 4 4 4 4 4 4 3 4 4 4 4 4 4 4 
4 4 4 4 4 4 4 3 4 3 1 1 3 4 4 4 4 4 4 3 1 1 1 1 1 1 1 3 4 4 4 4 4 4 3 5 3 4 4 4 4 3 5 3 4 4 1 1 1 1 1 1 1 1 1 1 1 1 1 1 1 1 1 1 1 1 1 1 1 1 1 1 1 1 1 1 1 1 1 1 1 4 4 4 4 4 4 4 4 4 4 4 3 4 4 4 4 4 4 4 
4 4 4 4 4 4 4 3 4 3 1 1 3 4 4 4 4 4 4 4 4 4 1 3 3 3 3 3 4 4 4 3 3 3 3 5 3 3 3 4 4 3 1 3 3 3 1 1 1 1 3 4 4 4 4 4 0 0 0 0 4 1 1 4 0 0 0 4 4 4 4 4 4 4 4 4 4 4 4 1 1 4 4 4 4 4 4 4 4 4 4 4 3 4 4 4 4 4 4 4 
4 4 4 4 4 4 4 3 4 3 1 1 3 3 3 4 4 4 4 4 4 4 6 4 4 4 4 4 0 0 4 3 0 0 0 0 0 0 3 4 4 3 1 1 1 1 1 1 1 1 3 4 5 5 5 4 7 0 0 0 0 1 1 0 0 0 7 4 5 5 5 4 4 4 4 4 4 4 4 4 1 4 4 4 4 4 4 4 4 4 4 4 3 4 4 4 4 4 4 4 
4 4 4 4 4 4 4 3 4 1 1 1 1 1 3 3 3 3 3 3 4 4 6 4 4 4 4 4 0 0 4 3 5 3 3 3 3 6 3 4 4 3 3 3 3 3 3 3 3 3 3 4 5 5 5 4 4 4 4 4 4 1 1 4 4 4 4 4 5 5 5 4 4 4 4 4 4 4 4 4 1 4 4 4 4 4 4 4 4 4 4 4 3 4 4 4 4 4 4 4 
4 4 4 4 4 4 4 3 4 1 4 1 1 1 1 1 1 1 1 3 4 4 6 4 4 0 0 0 4 4 4 3 0 3 0 0 3 0 3 4 4 4 4 4 4 4 4 4 4 4 4 4 5 5 5 4 4 4 4 4 4 1 1 4 4 4 4 4 5 5 5 4 4 4 4 4 4 4 4 4 1 4 4 4 4 4 4 4 4 4 4 4 3 4 4 4 4 4 4 4 
4 4 4 4 4 4 4 3 4 1 1 4 1 4 4 4 4 1 1 3 4 4 1 4 4 4 4 4 4 4 4 3 0 3 6 0 3 0 3 4 4 4 4 4 4 4 4 4 4 4 4 4 4 4 4 4 4 4 4 4 4 1 1 4 4 4 4 4 4 4 4 4 4 4 4 4 4 4 4 4 1 4 4 4 4 4 4 4 4 4 4 4 3 4 4 4 4 4 4 4 
4 4 4 4 4 4 4 3 4 1 4 1 1 4 0 0 4 1 1 3 4 4 1 1 1 1 5 4 0 4 4 3 6 3 6 3 3 5 3 4 4 4 4 4 4 4 4 4 4 4 4 4 4 4 4 4 4 4 4 4 4 1 1 4 4 4 4 4 4 4 4 4 4 4 4 4 4 4 4 4 1 4 4 4 4 4 4 4 4 4 4 4 3 4 4 4 4 4 4 4 
4 4 4 4 4 4 4 3 4 1 1 4 1 4 4 4 4 1 1 3 4 4 4 4 4 4 5 4 4 4 4 3 0 3 0 0 3 0 3 4 4 4 4 4 4 4 4 4 4 4 4 4 4 4 4 4 4 4 4 4 4 1 1 4 4 4 4 4 4 4 4 4 4 4 4 4 4 4 4 4 1 4 4 4 4 4 4 4 4 4 4 4 3 4 4 4 4 4 4 4 
4 4 4 4 4 4 4 3 4 1 1 1 1 1 6 6 1 1 1 3 4 4 4 4 4 4 5 4 4 4 4 3 0 3 3 0 3 0 3 4 4 4 4 4 4 4 4 4 4 4 4 4 4 4 4 4 4 4 4 4 4 1 1 4 4 4 4 4 4 4 4 4 4 4 4 4 4 4 4 4 1 4 4 4 4 4 4 4 4 4 4 4 3 4 4 4 4 4 4 4 
4 4 4 4 4 4 4 3 4 4 4 4 1 4 4 4 4 1 3 3 4 4 4 4 1 1 1 3 1 4 4 3 5 3 0 5 3 6 3 4 4 4 4 4 4 4 4 4 4 4 4 4 4 4 4 4 4 4 4 4 1 1 1 1 4 4 4 4 4 4 4 4 4 4 4 4 4 4 4 4 1 4 4 4 4 4 4 4 4 4 4 4 3 4 4 4 4 4 4 4 
4 4 4 4 4 4 4 3 7 4 7 4 1 1 5 5 1 1 3 4 4 4 4 4 1 1 3 1 1 4 4 3 0 3 0 3 3 0 3 4 4 4 4 4 4 4 4 4 4 4 4 4 4 4 4 4 4 4 4 4 1 1 1 1 4 4 4 4 4 4 4 4 4 4 4 4 4 4 4 4 1 4 4 4 4 4 4 4 4 4 4 4 3 4 4 4 4 4 4 4 
4 4 4 4 4 4 4 3 3 3 3 3 3 3 3 3 3 3 3 4 4 4 4 4 1 3 1 1 1 4 4 3 0 3 6 0 0 5 3 4 4 4 4 4 4 4 4 4 4 4 4 4 4 4 4 4 4 4 4 1 1 1 1 1 1 4 4 4 4 4 4 4 4 4 4 4 4 4 4 0 0 0 0 0 4 4 4 4 4 4 4 4 3 4 4 4 4 4 4 4 
4 4 4 4 4 4 4 3 4 4 4 4 4 4 4 4 4 4 4 4 4 4 4 4 1 1 1 1 1 4 4 3 6 3 3 3 3 0 3 4 4 4 4 4 4 4 4 4 4 4 4 4 4 4 4 4 4 4 4 1 1 1 1 1 1 4 4 4 4 4 4 4 4 4 4 4 4 4 0 0 0 0 0 0 4 4 4 4 4 4 4 4 3 4 4 4 4 4 4 4 
4 4 4 4 4 4 4 3 4 4 4 4 4 4 4 4 4 4 4 4 4 4 4 4 4 4 4 4 4 4 4 3 0 0 5 6 0 0 3 4 4 4 4 4 4 4 4 4 4 4 4 4 4 4 4 4 4 4 4 4 5 5 5 5 4 4 4 4 4 4 4 4 4 4 4 4 4 0 0 0 4 0 4 0 0 4 4 4 4 4 4 4 3 4 4 4 4 4 4 4 
4 4 4 4 4 4 4 3 4 4 4 4 4 4 4 4 4 4 4 4 4 4 4 4 4 4 4 4 4 4 4 3 3 3 3 3 3 3 3 4 4 4 4 4 4 4 4 4 4 4 4 4 4 4 4 4 4 4 4 4 5 5 5 5 4 4 4 4 4 4 4 4 4 4 4 4 4 0 0 4 0 4 0 0 0 4 4 4 4 4 4 4 3 4 4 4 4 4 4 4 
4 4 4 4 4 4 4 3 4 4 4 4 4 4 4 4 4 4 4 4 4 4 4 4 4 4 4 4 4 4 4 4 4 4 4 4 4 4 4 4 4 4 4 4 4 4 4 4 4 0 0 4 4 4 4 4 4 4 4 4 5 5 5 5 4 4 4 4 4 1 1 1 1 1 1 1 1 0 0 0 0 0 0 0 0 4 4 4 4 4 4 4 3 4 4 4 4 4 4 4 
4 4 4 4 4 4 4 3 4 4 4 4 4 4 4 4 4 4 4 4 4 4 4 4 4 4 4 4 4 4 4 4 4 4 4 4 4 4 4 4 4 4 4 4 4 4 4 4 4 0 0 4 4 4 4 4 4 4 4 4 5 5 5 5 4 4 4 4 4 1 1 1 1 1 1 1 1 0 0 0 0 0 0 0 0 4 4 4 4 4 4 4 3 4 4 4 4 4 4 4 
4 4 4 4 4 4 4 3 4 4 4 4 4 4 4 4 4 4 4 4 4 4 4 4 4 4 4 4 4 4 4 4 4 4 4 4 4 4 4 4 4 4 4 4 0 0 0 0 4 4 4 4 4 4 4 4 4 4 4 4 4 1 1 4 4 4 4 0 0 1 1 4 4 4 4 4 4 4 4 4 4 4 4 4 4 4 4 4 4 4 4 4 3 4 4 4 4 4 4 4 
4 4 4 4 4 4 4 3 4 4 4 4 4 4 4 4 4 4 4 4 4 4 4 4 4 4 4 4 4 4 4 4 4 4 4 4 4 4 4 4 4 4 4 4 0 0 0 0 4 4 4 4 4 4 4 4 4 4 4 4 4 1 1 4 4 4 4 0 1 1 1 4 4 4 4 4 4 4 4 4 4 4 4 4 4 4 4 4 4 4 4 4 3 4 4 4 4 4 4 4 
4 4 4 4 4 4 4 3 4 4 4 4 4 4 4 4 4 4 4 4 4 4 4 4 4 4 4 4 4 4 4 4 4 4 3 3 3 3 3 4 4 4 4 4 0 0 0 0 0 1 1 1 1 1 1 1 4 4 4 4 4 1 1 4 4 4 1 1 1 1 4 4 4 4 4 4 4 4 4 4 4 4 4 4 4 4 4 4 4 4 4 4 3 4 4 4 4 4 4 4 
4 4 4 4 4 4 4 3 4 4 4 4 4 4 4 4 4 4 4 4 4 4 4 4 4 4 4 4 4 4 4 4 4 4 3 2 2 2 2 4 4 4 4 4 0 4 0 0 0 4 4 4 4 4 4 1 4 4 4 4 4 1 1 1 1 1 1 1 1 0 4 4 4 4 4 4 4 4 4 4 4 4 4 4 4 4 4 4 4 4 4 4 3 4 4 4 4 4 4 4 
4 4 4 4 4 4 4 3 4 4 4 4 4 4 4 4 4 4 4 4 4 4 4 4 4 4 4 4 4 4 4 4 4 4 3 2 2 2 2 4 4 4 4 4 0 7 4 0 0 4 4 4 4 4 4 1 4 4 4 4 4 1 1 1 1 1 1 1 0 0 4 4 4 4 4 4 4 4 4 4 4 4 4 4 4 4 4 4 4 4 4 4 3 4 4 4 4 4 4 4 
4 4 4 4 4 4 4 3 4 4 4 4 4 4 4 4 4 4 4 4 4 4 4 4 4 4 4 4 4 4 4 4 4 4 3 2 2 2 2 0 0 0 0 0 0 4 0 0 4 0 0 4 4 4 4 1 1 1 1 1 1 1 1 4 4 4 4 4 4 4 4 4 4 4 4 4 4 4 4 4 4 4 4 4 4 4 4 4 4 4 4 4 3 4 4 4 4 4 4 4 
4 4 4 4 4 4 4 3 4 4 4 4 4 4 4 4 4 4 4 4 4 4 4 4 4 4 4 4 4 4 4 4 4 4 3 2 2 2 2 4 4 4 4 4 0 0 0 0 4 0 0 4 4 4 4 4 4 4 4 4 4 4 4 4 4 4 4 4 4 4 4 4 4 4 4 4 4 4 4 4 4 4 4 4 4 4 4 4 4 4 4 4 3 4 4 4 4 4 4 4 
4 4 4 4 4 4 4 3 3 3 3 3 3 3 3 3 3 3 3 3 3 3 3 3 3 3 3 3 3 3 3 3 3 3 3 2 2 2 2 4 4 4 4 4 4 4 4 4 4 4 4 4 4 4 4 4 4 4 4 4 4 4 4 4 4 4 4 4 4 4 4 4 4 4 4 4 4 4 4 4 4 4 4 4 4 4 4 4 4 4 4 4 3 4 4 4 4 4 4 4 
4 4 4 4 4 4 4 3 4 4 4 4 4 4 4 4 4 4 4 4 4 4 4 4 4 4 4 4 4 4 4 4 4 4 3 3 3 3 3 3 4 4 4 4 4 4 4 4 4 4 4 4 4 4 4 4 4 4 4 4 4 4 4 4 4 4 4 4 4 4 4 4 4 4 4 4 4 4 4 4 4 4 4 4 4 4 4 4 4 4 4 4 3 4 4 4 4 4 4 4 
4 4 4 4 4 4 4 3 4 4 4 4 4 4 4 4 4 4 4 4 4 4 4 4 4 4 4 4 4 4 4 4 4 4 4 4 4 4 4 4 4 4 4 4 4 4 4 4 4 4 4 4 4 4 4 4 4 4 4 4 4 4 4 4 4 4 4 4 4 4 4 4 4 4 4 4 4 4 4 4 4 4 4 4 4 4 4 4 4 4 4 4 3 4 4 4 4 4 4 4 
4 4 4 4 4 4 4 3 4 1 1 1 1 1 1 1 1 1 1 1 4 4 4 4 4 4 4 4 4 4 4 4 4 4 4 4 4 4 4 4 4 4 4 4 4 4 4 4 4 4 4 4 4 4 4 4 4 4 4 4 4 4 4 4 4 4 4 4 4 4 4 4 4 4 4 4 4 4 4 4 4 4 4 4 4 4 4 4 4 4 4 4 3 4 4 4 4 4 4 4 
4 4 4 4 4 4 4 3 4 1 1 1 1 1 1 1 1 1 1 1 4 4 4 4 4 4 4 4 4 4 4 4 4 4 4 4 4 4 4 4 4 4 4 4 4 4 4 4 4 4 4 4 4 4 4 4 4 4 4 4 4 4 4 4 4 4 4 4 4 4 4 4 4 4 4 4 4 4 4 4 4 4 4 4 4 4 4 4 4 4 4 4 3 4 4 4 4 4 4 4 
4 4 4 4 4 4 4 3 4 1 1 1 6 1 1 1 5 1 1 1 4 4 4 4 4 4 4 4 4 4 4 4 4 4 4 4 4 4 4 3 3 3 3 3 3 3 3 3 3 3 4 4 4 4 4 4 4 4 4 4 4 4 4 4 4 4 4 4 4 4 4 4 4 4 4 4 4 4 4 4 4 4 4 4 4 4 4 4 4 4 4 4 3 4 4 4 4 4 4 4 
4 4 4 4 4 4 4 3 4 1 1 6 1 6 1 5 1 5 1 1 4 4 4 4 4 4 4 4 4 4 4 4 4 4 4 4 4 4 4 3 1 1 1 1 1 1 1 1 1 3 3 3 3 3 3 3 3 3 3 4 4 4 4 4 4 4 3 3 3 3 3 3 3 3 3 4 4 4 4 3 3 3 3 3 3 4 4 4 4 4 4 4 3 4 4 4 4 4 4 4 
4 4 4 4 4 4 4 3 4 1 6 1 1 1 5 1 1 1 5 1 4 4 4 4 4 4 4 4 4 4 4 4 4 4 4 4 4 4 4 3 1 1 1 1 0 1 1 1 1 1 6 6 1 5 1 1 1 1 3 4 4 3 3 3 3 3 3 1 1 1 6 1 1 1 3 4 4 4 4 3 1 1 6 1 3 4 4 4 4 4 4 4 3 4 4 4 4 4 4 4 
4 4 4 4 4 4 4 3 4 1 1 6 1 1 1 1 1 5 1 1 4 4 4 4 4 4 4 4 4 4 4 4 4 4 4 4 4 4 4 3 1 1 1 0 0 1 1 1 1 3 3 3 3 3 3 3 3 6 3 4 3 3 1 6 1 1 3 1 5 3 3 3 3 6 3 4 4 4 4 3 1 3 3 6 3 3 3 3 3 3 3 4 3 4 4 4 4 4 4 4 
4 4 4 4 4 4 4 3 4 1 1 1 6 1 1 1 5 1 1 1 4 4 4 4 4 4 4 4 4 4 4 4 4 4 4 4 4 4 4 3 1 1 1 1 0 1 1 1 1 3 4 4 3 6 1 5 1 1 3 4 3 1 1 3 3 1 3 3 1 3 4 4 3 1 3 4 3 3 3 3 5 3 3 6 1 5 1 1 1 1 3 4 3 4 4 4 4 4 4 4 
4 4 4 4 4 4 4 3 4 1 1 1 1 6 1 5 1 1 1 1 4 4 4 4 4 4 4 4 4 4 4 4 4 4 4 4 4 4 4 3 1 1 1 1 0 1 1 1 1 3 4 4 3 6 3 3 3 3 3 3 3 5 3 3 3 5 3 3 1 3 4 3 1 5 3 3 3 1 5 1 1 3 3 3 3 3 3 3 3 1 3 4 3 4 4 4 4 4 4 4 
4 4 4 4 4 4 4 3 4 3 1 1 1 1 6 1 1 1 1 3 4 4 4 4 4 4 4 4 4 4 4 4 4 4 4 4 4 4 4 3 1 1 1 0 0 0 1 1 1 3 4 4 3 1 6 1 1 1 5 1 1 1 3 4 3 1 6 1 6 3 4 3 6 1 1 6 1 1 3 3 3 3 4 4 4 4 4 4 4 1 3 4 3 4 4 4 4 4 4 4 
4 4 4 4 4 4 4 3 4 3 3 3 3 3 6 3 3 3 3 3 4 4 4 4 4 4 4 4 4 4 4 4 4 4 4 4 4 4 4 3 1 1 1 1 1 1 1 1 1 3 4 4 3 3 3 3 3 3 3 3 3 3 3 4 3 3 3 3 3 3 4 3 3 3 3 3 3 3 3 4 4 3 3 3 3 1 1 1 1 1 3 4 3 4 4 4 4 4 4 4 
4 4 4 4 4 4 4 3 4 4 4 4 4 3 6 3 4 4 4 4 4 4 4 4 4 4 4 4 4 4 4 4 4 4 4 4 4 4 4 3 3 3 3 3 3 3 3 3 3 3 4 4 4 4 4 4 4 4 4 4 4 4 4 4 4 4 4 4 4 4 4 4 4 4 4 4 4 4 4 4 3 2 0 0 2 1 0 4 0 0 3 4 3 4 4 4 4 4 4 4 
4 4 4 4 4 4 4 3 4 4 4 4 4 3 6 3 4 4 4 4 4 4 4 4 4 4 4 4 4 4 4 4 4 4 4 4 4 4 4 3 3 3 3 3 3 3 3 3 3 3 4 4 4 4 4 4 4 4 4 4 4 4 4 4 4 4 4 4 4 4 4 4 4 4 4 4 4 4 4 4 3 0 1 1 0 1 4 0 4 4 3 4 3 4 4 4 4 4 4 4 
4 4 4 4 4 4 4 3 4 4 4 4 4 3 6 3 4 4 4 4 4 4 4 4 4 4 4 4 4 4 4 4 4 4 4 4 4 4 4 3 1 1 1 1 1 1 1 1 1 3 4 4 4 4 4 4 4 4 4 4 4 4 4 4 4 4 4 4 4 4 4 4 4 4 4 4 4 4 4 4 3 2 0 0 2 1 1 1 1 1 3 4 3 4 4 4 4 4 4 4 
4 4 4 4 4 4 4 3 4 4 4 4 4 3 6 3 4 4 4 4 4 4 4 4 4 4 4 4 4 4 4 4 4 4 4 4 4 4 4 3 1 1 1 0 0 0 1 1 1 3 4 4 4 4 4 4 4 4 4 4 4 4 4 4 4 4 4 4 4 4 4 4 4 4 4 4 4 4 4 4 4 3 3 3 3 4 4 4 4 1 3 4 3 4 4 4 4 4 4 4 
4 4 4 4 4 4 4 3 4 4 4 4 4 3 6 3 4 4 4 4 4 4 4 4 4 4 4 4 4 4 4 4 4 4 4 4 4 4 4 3 1 1 1 1 1 0 1 1 1 3 3 3 3 3 3 3 3 3 3 3 3 3 3 3 3 3 3 3 3 3 3 3 3 3 3 3 3 3 3 3 3 3 3 3 3 3 3 3 3 1 3 4 3 4 4 4 4 4 4 4 
4 4 4 4 4 4 4 3 4 4 4 4 4 3 6 3 4 4 4 4 4 4 4 4 4 4 4 4 4 0 0 0 0 0 0 4 4 4 4 3 1 1 1 0 0 0 1 1 1 1 1 1 1 1 1 1 1 1 1 1 1 1 1 1 1 1 1 1 1 1 1 1 1 1 1 1 1 1 1 1 1 1 1 1 1 1 1 1 1 1 3 4 3 4 4 4 4 4 4 4 
4 4 4 4 4 4 4 3 4 4 4 4 4 3 6 3 4 4 4 4 4 4 4 4 4 4 4 4 4 0 0 0 0 0 0 0 4 4 4 3 1 1 1 0 1 1 1 1 1 3 3 3 3 3 3 3 3 1 4 4 0 4 4 0 0 0 4 4 4 4 0 0 0 4 4 0 0 4 0 4 4 4 4 4 4 4 4 4 4 1 3 4 3 4 4 4 4 4 4 4 
4 4 4 4 4 4 4 3 4 4 4 4 4 3 6 3 4 4 4 4 4 4 4 4 4 4 4 4 0 0 0 4 4 4 4 0 4 4 4 3 1 1 1 0 0 0 1 1 1 3 4 4 4 4 4 4 3 1 4 0 4 0 0 4 4 4 0 0 0 0 4 4 4 0 4 0 4 4 4 0 4 4 4 4 4 4 4 4 4 1 3 4 3 4 4 4 4 4 4 4 
4 4 4 4 4 4 4 3 4 4 4 4 4 3 6 3 4 4 4 4 4 4 4 4 4 4 4 4 4 4 4 4 4 4 4 4 4 4 4 3 1 1 1 1 1 1 1 1 1 3 4 4 4 4 4 4 3 1 1 1 1 1 1 1 1 1 1 1 1 1 1 1 1 1 1 1 1 1 1 1 1 1 1 1 1 1 1 1 1 1 3 4 3 4 4 4 4 4 4 4 
4 4 4 4 4 4 4 3 4 4 4 4 4 3 6 3 4 4 4 4 4 4 4 4 4 4 4 4 4 4 4 4 4 4 4 4 4 4 4 3 3 3 3 3 3 3 3 3 3 3 4 4 4 4 4 4 3 3 3 3 3 3 3 3 3 3 3 3 3 3 3 3 3 3 3 3 3 3 3 3 3 3 3 3 3 3 3 3 3 3 3 4 3 4 4 4 4 4 4 4 
4 4 4 4 4 4 4 3 4 4 4 4 4 3 6 3 4 4 4 4 4 4 4 4 4 4 4 3 3 3 3 3 3 3 3 3 4 4 4 3 3 3 3 3 3 3 3 3 3 3 4 4 4 4 4 4 4 4 4 4 4 4 4 4 4 4 4 4 4 4 4 4 4 4 4 4 4 4 4 4 4 4 4 4 4 4 4 4 4 4 4 4 3 4 4 4 4 4 4 4 
4 4 4 4 4 4 4 3 4 4 4 4 4 3 6 3 4 4 4 4 4 4 4 4 4 4 4 3 1 1 1 1 1 1 1 3 4 4 4 3 1 1 1 1 1 1 1 1 1 3 4 4 4 4 4 4 4 4 4 4 4 4 4 4 4 4 4 4 4 4 4 4 4 4 4 4 4 4 4 4 4 4 4 4 4 4 4 4 4 4 4 4 3 4 4 4 4 4 4 4 
4 4 4 4 4 4 4 3 4 4 4 4 4 3 6 3 4 4 4 4 4 4 4 4 4 4 4 3 1 1 1 1 1 1 1 3 4 4 4 3 1 1 1 0 0 0 1 1 1 3 4 4 4 4 4 4 4 4 4 4 4 4 4 4 4 4 4 4 4 4 4 4 4 4 4 4 4 4 4 4 4 4 4 4 4 4 4 4 4 4 4 4 3 4 4 4 4 4 4 4 
4 4 4 4 4 4 4 3 4 4 4 4 4 3 6 3 4 4 4 4 4 4 4 4 4 4 4 3 1 1 1 1 1 1 1 3 4 4 4 3 1 1 1 1 1 0 1 1 1 3 3 3 3 3 3 3 3 3 3 3 3 3 3 3 3 3 3 3 3 4 4 4 4 4 4 4 4 4 4 4 4 4 4 4 4 4 4 4 4 4 4 4 3 4 4 4 4 4 4 4 
4 4 4 4 4 4 4 3 4 4 4 3 3 3 6 3 3 3 3 3 4 4 4 4 4 4 4 3 1 1 1 1 1 1 1 3 4 4 4 3 1 1 1 0 0 0 1 1 1 1 1 1 1 1 1 1 1 1 1 1 1 1 1 1 1 1 1 1 3 4 4 4 4 4 4 4 4 4 4 4 4 4 4 4 4 4 4 4 4 4 4 4 3 4 4 4 4 4 4 4 
4 4 4 4 4 4 4 3 4 4 4 3 1 1 1 1 1 1 1 3 4 4 4 4 4 4 4 3 1 1 1 1 1 1 1 3 4 4 4 3 1 1 1 1 1 0 1 1 1 3 3 3 3 3 3 3 3 1 3 3 3 3 1 3 3 3 3 1 3 4 4 4 4 4 4 4 4 4 4 4 4 4 4 4 4 4 4 4 4 4 4 4 3 4 4 4 4 4 4 4 
4 4 4 4 4 4 4 3 4 4 4 3 3 3 5 3 6 3 3 3 4 4 4 4 4 4 4 3 1 1 1 1 1 1 1 3 4 4 4 3 1 1 1 0 0 0 1 1 1 3 4 4 4 4 4 7 3 1 3 7 4 3 1 3 7 4 3 1 3 4 4 4 4 4 4 4 4 4 4 4 4 4 4 4 4 4 4 4 4 4 4 4 4 4 4 4 4 4 4 4 
4 4 4 4 4 4 4 3 4 4 4 3 5 5 5 3 6 6 6 3 4 4 4 4 4 4 4 3 1 1 1 1 1 1 1 3 4 4 4 3 1 1 1 1 1 1 1 1 1 3 4 4 4 4 4 7 3 3 3 7 4 3 3 3 7 4 3 3 3 4 4 4 4 4 4 4 4 4 4 4 4 4 4 4 4 4 4 4 4 4 4 4 4 4 4 4 4 4 4 4 
4 4 4 4 4 4 4 3 4 4 4 3 5 5 5 3 6 6 6 3 4 4 4 4 4 4 4 3 3 3 1 3 1 3 3 3 4 4 4 3 3 3 3 3 3 3 3 3 3 3 4 4 4 4 4 4 4 4 4 4 4 4 4 4 4 4 4 4 4 4 4 4 4 4 4 4 4 4 4 4 4 4 4 4 4 4 4 4 4 4 4 4 4 4 4 4 4 4 4 4 
4 4 4 4 4 4 4 3 4 4 4 3 5 5 5 3 6 6 6 3 4 4 4 4 4 4 4 4 4 3 6 3 5 3 4 4 4 4 4 4 4 4 4 4 4 4 4 4 4 4 4 4 4 4 4 4 4 4 4 4 4 4 4 4 4 4 4 4 4 4 4 4 4 4 4 4 4 4 4 4 4 4 4 4 4 4 4 4 4 4 4 4 4 4 4 4 4 4 4 4 
4 4 4 4 4 4 4 3 4 4 4 3 5 5 5 3 6 6 6 3 4 4 4 4 4 4 4 4 4 3 6 3 5 3 4 4 4 4 4 4 4 4 4 4 4 4 4 4 4 4 4 4 4 4 4 4 4 4 4 4 4 4 4 4 4 4 4 4 4 4 4 4 4 4 4 4 4 4 4 4 4 4 4 4 4 4 4 4 4 4 4 4 4 4 4 4 4 4 4 4 
4 4 4 4 4 4 4 3 4 4 4 3 5 5 3 4 3 6 6 3 4 4 4 4 4 4 4 4 4 3 6 3 5 3 4 4 4 4 4 4 4 4 4 4 4 4 4 4 4 4 4 4 4 4 4 4 4 4 4 4 4 4 4 4 4 4 4 4 4 4 4 4 4 4 4 4 4 4 4 4 4 4 4 4 4 4 4 4 4 4 4 4 4 4 4 4 4 4 4 4 
4 4 4 4 4 4 4 3 4 4 4 3 3 5 3 7 3 6 3 3 4 4 4 4 4 4 4 4 4 3 6 3 5 3 4 4 4 4 4 4 4 4 4 4 4 4 4 4 4 4 4 4 4 4 4 4 4 4 4 4 4 4 4 4 4 4 4 4 4 4 4 4 4 4 4 4 4 4 4 4 4 4 4 4 4 4 4 4 4 4 4 4 4 4 4 4 4 4 4 4 
4 4 4 4 4 4 4 3 4 4 4 4 3 5 3 7 3 6 3 3 3 3 3 3 3 3 3 3 3 3 6 3 5 3 4 4 4 4 4 4 4 4 4 4 4 4 4 4 4 4 4 4 4 4 4 4 4 4 4 4 4 4 4 4 4 4 4 4 4 4 4 4 4 4 4 4 4 4 4 4 4 4 4 4 4 4 4 4 4 4 4 4 4 4 4 4 4 4 4 4 
4 4 4 4 4 4 4 3 4 4 4 4 4 5 3 4 3 6 6 6 6 6 6 6 6 6 6 6 6 6 6 3 5 3 4 4 4 4 4 4 4 4 4 4 4 4 4 4 4 4 4 4 4 4 4 4 4 4 4 4 4 4 4 4 4 4 4 4 4 4 4 4 4 4 4 4 4 4 4 4 4 4 4 4 4 4 4 4 4 4 4 4 4 4 4 4 4 4 4 4 
4 4 4 4 4 4 4 3 4 4 4 4 4 5 3 3 3 3 3 3 3 3 3 3 3 3 3 3 3 3 3 3 5 3 4 4 4 4 4 4 4 4 4 4 4 4 4 4 4 4 4 4 4 4 4 4 4 4 4 4 4 4 4 4 4 4 4 4 4 4 4 4 4 4 4 4 4 4 4 4 4 4 4 4 4 4 4 4 4 4 4 4 4 4 4 4 4 4 4 4 
4 4 4 4 4 4 4 3 4 4 4 4 4 5 5 5 5 5 5 5 5 5 5 5 5 5 5 5 5 5 5 5 5 3 4 4 4 4 4 4 4 4 4 4 4 4 4 4 4 4 4 4 4 4 4 4 4 4 4 4 4 4 4 4 4 4 4 4 4 4 4 4 4 4 4 4 4 4 4 4 4 4 4 4 4 4 4 4 4 4 4 4 4 4 4 4 4 4 4 4 
4 4 4 4 4 4 4 3 4 4 4 4 4 4 4 4 4 4 4 4 4 4 4 4 4 4 4 4 4 4 4 4 4 4 4 4 4 4 4 4 4 4 4 4 4 4 4 4 4 4 4 4 4 4 4 4 4 4 4 4 4 4 4 4 4 4 4 4 4 4 4 4 4 4 4 4 4 4 4 4 4 4 4 4 4 4 4 4 4 4 4 4 4 4 4 4 4 4 4 4 
4 4 4 4 4 4 4 3 3 3 3 3 3 3 3 3 3 3 3 3 3 3 3 3 3 3 3 3 3 3 3 3 3 3 3 3 3 3 3 3 3 3 3 3 3 3 3 3 3 3 3 3 3 3 3 3 3 3 3 3 3 3 3 3 3 3 3 3 4 4 4 4 4 4 4 4 4 4 4 4 4 4 4 4 4 4 4 4 4 4 4 4 4 4 4 4 4 4 4 4 
4 4 4 4 4 4 4 4 4 4 4 4 4 4 4 4 4 4 4 4 4 4 4 4 4 4 4 4 4 4 4 4 4 4 4 4 4 4 4 4 4 4 4 4 4 4 4 4 4 4 4 4 4 4 4 4 4 4 4 4 4 4 4 4 4 4 4 4 4 4 4 4 4 4 4 4 4 4 4 4 4 4 4 4 4 4 4 4 4 4 4 4 4 4 4 4 4 4 4 4 
4 4 4 4 4 4 4 4 4 4 4 4 4 4 4 4 4 4 4 4 4 4 4 4 4 4 4 4 4 4 4 4 4 4 4 4 4 4 4 4 4 4 4 4 4 4 4 4 4 4 4 4 4 4 4 4 4 4 4 4 4 4 4 4 4 4 4 4 4 4 4 4 4 4 4 4 4 4 4 4 4 4 4 4 4 4 4 4 4 4 4 4 4 4 4 4 4 4 4 4 
4 4 4 4 4 4 4 4 4 4 4 4 4 4 4 4 4 4 4 4 4 4 4 4 4 4 4 4 4 4 4 4 4 4 4 4 4 4 4 4 4 4 4 4 4 4 4 4 4 4 4 4 4 4 4 4 4 4 4 4 4 4 4 4 4 4 4 4 4 4 4 4 4 4 4 4 4 4 4 4 4 4 4 4 4 4 4 4 4 4 4 4 4 4 4 4 4 4 4 4 
4 4 4 4 4 4 4 4 4 4 4 4 4 4 4 4 4 4 4 4 4 4 4 4 4 4 4 4 4 4 4 4 4 4 4 4 4 4 4 4 4 4 4 4 4 4 4 4 4 4 4 4 4 4 4 4 4 4 4 4 4 4 4 4 4 4 4 4 4 4 4 4 4 4 4 4 4 4 4 4 4 4 4 4 4 4 4 4 4 4 4 4 4 4 4 4 4 4 4 4 
4 4 4 4 4 4 4 4 4 4 4 4 4 4 4 4 4 4 4 4 4 4 4 4 4 4 4 4 4 4 4 4 4 4 4 4 4 4 4 4 4 4 4 4 4 4 4 4 4 4 4 4 4 4 4 4 4 4 4 4 4 4 4 4 4 4 4 4 4 4 4 4 4 4 4 4 4 4 4 4 4 4 4 4 4 4 4 4 4 4 4 4 4 4 4 4 4 4 4 4 
