4 4 4 4 4 4 4 4 4 4 4 4 4 4 4 4 4 4 4 4 4 4 4 4 4 4 4 4 4 4 4 4 4 4 4 4 4 4 4 4 4 4 4 4 4 4 4 4 4 4 4 4 4 4 4 4 4 4 4 4 4 4 4 4 4 4 4 4 4 4 4 4 4 4 4 4 4 4 4 4 4 4 4 4 4 4 4 4 4 4 4 4 4 4 4 4 4 4 4 4 
4 4 4 4 4 4 4 4 4 4 4 4 4 4 4 4 4 4 4 4 4 4 4 4 4 4 4 4 4 4 4 4 4 4 4 4 4 4 4 4 4 4 4 4 4 4 4 4 4 4 4 4 4 4 4 4 4 4 4 4 4 4 4 4 4 4 4 4 4 4 4 4 4 4 4 4 4 4 4 4 4 4 4 4 4 4 4 4 4 4 4 4 4 4 4 4 4 4 4 4 
4 4 4 4 4 4 4 4 4 4 4 4 4 4 4 4 4 4 4 4 4 4 4 4 4 4 4 4 4 4 4 4 4 4 4 4 4 4 4 4 4 4 4 4 4 4 4 4 4 4 4 4 4 4 4 4 4 4 4 4 4 4 4 4 4 4 4 4 4 4 4 4 4 4 4 4 4 4 4 4 4 4 4 4 4 4 4 4 4 4 4 4 4 4 4 4 4 4 4 4 
4 4 4 4 4 4 4 4 4 4 4 4 4 4 4 4 4 4 4 4 4 4 4 4 4 4 4 4 4 4 4 4 4 4 4 4 4 4 4 4 4 4 4 4 4 4 4 4 4 4 4 4 4 4 4 4 4 4 4 4 4 4 4 4 4 4 4 4 4 4 4 4 4 4 4 4 4 4 4 4 4 4 4 4 4 4 4 4 4 4 4 4 4 4 4 4 4 4 4 4 
4 4 4 4 4 4 4 4 4 4 4 4 4 4 4 4 4 4 4 4 4 4 4 4 4 4 4 4 4 4 4 4 4 4 4 4 4 4 4 4 4 4 4 4 4 4 4 4 4 4 4 4 4 4 4 4 4 4 4 4 4 4 4 4 4 4 4 4 4 4 4 4 4 4 4 4 4 4 4 4 4 4 4 4 4 4 4 4 4 4 4 4 4 4 4 4 4 4 4 4 
4 4 4 4 4 4 4 3 3 3 3 3 3 3 3 3 3 3 3 3 3 3 3 3 3 3 3 3 3 3 3 3 3 3 3 3 3 3 3 3 3 3 3 3 3 3 3 3 3 3 3 3 3 3 3 3 3 3 3 3 3 3 3 3 3 3 3 3 3 3 3 3 3 3 3 3 3 3 3 3 3 3 3 3 3 3 3 3 3 3 3 3 3 4 4 4 4 4 4 4 
4 4 4 4 4 4 4 3 4 4 4 4 4 4 4 4 4 4 4 4 4 4 4 4 4 4 4 4 4 4 4 4 4 4 4 4 4 4 4 4 4 4 4 4 4 4 4 4 4 4 4 4 4 4 4 4 4 4 4 4 4 4 4 4 4 4 4 4 4 4 4 4 4 4 4 4 4 4 4 4 4 4 4 4 4 4 4 4 4 4 4 4 3 4 4 4 4 4 4 4 
4 4 4 4 4 4 4 3 4 4 4 4 4 4 4 4 4 4 4 4 4 4 4 4 4 4 4 4 4 4 2 4 4 4 4 4 4 4 4 4 4 3 3 3 3 3 3 3 3 3 3 3 3 4 4 4 3 3 3 3 3 3 3 3 3 3 3 3 3 3 3 3 3 3 3 4 4 4 4 4 4 4 4 4 4 4 4 3 3 3 4 4 3 4 4 4 4 4 4 4 
4 4 4 4 4 4 4 3 4 4 1 1 1 1 1 1 1 1 1 1 4 4 4 4 4 4 4 4 4 2 2 4 4 4 4 4 4 4 4 4 4 3 1 1 1 1 1 1 1 1 12 9 3 4 4 4 3 1 1 13 1 1 1 1 1 1 1 1 1 1 1 12 1 11 3 4 4 4 4 4 4 4 4 4 4 4 4 3 15 3 4 4 3 4 4 4 4 4 4 4 
4 4 4 4 4 4 4 3 4 4 1 1 1 1 1 1 1 1 1 1 4 4 4 4 4 4 4 4 2 4 2 4 4 4 4 4 4 4 4 4 4 3 1 3 3 3 3 3 3 3 3 3 3 4 4 4 3 1 3 3 3 3 3 3 3 3 3 1 3 3 3 3 3 3 3 4 4 4 4 4 4 4 4 4 4 4 4 3 6 3 4 4 3 4 4 4 4 4 4 4 
4 4 4 4 4 4 4 3 4 4 1 1 1 1 1 1 1 1 1 1 4 4 4 4 4 4 4 2 4 4 2 4 4 4 4 4 4 4 4 4 4 3 1 3 4 4 4 4 4 4 4 4 4 4 4 4 3 1 3 4 4 4 4 4 4 4 3 1 3 4 4 4 4 4 4 4 4 4 4 4 4 4 4 4 4 4 4 3 6 3 4 4 3 4 4 4 4 4 4 4 
4 4 4 4 4 4 4 3 4 4 1 1 1 1 1 1 1 1 1 1 4 4 4 4 4 4 2 4 4 4 2 4 4 4 4 4 4 4 4 4 4 3 1 3 3 3 3 3 3 3 3 3 3 3 3 3 3 1 3 4 4 4 4 4 4 4 3 1 3 4 4 4 4 4 4 3 3 3 3 3 3 3 4 4 4 4 4 3 6 3 4 4 3 4 4 4 4 4 4 4 
4 4 4 4 4 4 4 3 4 4 1 1 1 1 1 1 1 1 1 1 4 4 4 4 4 4 4 4 4 4 2 4 4 4 4 4 4 4 4 4 4 3 1 1 1 1 1 1 1 1 1 1 1 1 1 1 1 1 3 4 4 4 4 4 4 4 3 1 3 4 4 4 4 4 4 3 11 3 11 3 9 3 4 4 4 4 4 3 6 3 4 4 3 4 4 4 4 4 4 4 
4 4 4 4 4 4 4 3 4 4 1 1 1 3 1 1 3 1 1 1 4 4 4 4 4 4 4 4 4 4 2 4 4 4 4 4 4 4 4 4 4 3 1 3 3 3 3 3 3 3 3 3 3 3 3 3 3 3 3 4 4 4 4 4 4 4 3 1 3 4 4 4 4 4 4 3 1 3 1 3 1 3 4 4 4 4 4 3 6 3 4 4 3 4 4 4 4 4 4 4 
4 4 4 4 4 4 4 3 4 4 4 4 4 4 1 1 4 4 4 4 4 4 4 4 4 4 4 4 4 4 2 4 4 4 4 4 4 4 4 4 4 3 1 3 4 4 4 4 4 4 4 4 4 4 4 4 4 4 4 4 4 4 4 4 4 4 3 1 3 4 4 4 4 4 4 3 1 3 1 3 1 3 4 4 4 4 4 3 6 3 4 4 3 4 4 4 4 4 4 4 
4 4 4 4 4 4 4 3 4 4 4 4 4 4 1 1 4 4 4 4 4 4 4 4 4 4 4 4 4 4 2 4 4 4 4 4 4 4 4 4 4 3 1 3 3 3 3 3 3 3 3 4 4 4 4 4 4 4 4 4 4 4 4 4 4 4 3 1 3 4 4 4 4 4 4 3 1 3 1 3 1 3 4 4 4 4 4 3 6 3 4 4 3 4 4 4 4 4 4 4 
4 4 4 4 4 4 4 3 4 4 4 4 4 4 5 5 4 4 4 4 4 4 4 4 4 4 4 4 4 4 2 4 4 4 4 4 4 4 4 4 4 3 1 1 1 1 1 1 1 13 3 4 4 4 4 4 4 4 4 4 4 4 4 4 4 4 3 1 3 4 4 4 4 4 4 3 1 3 1 3 1 3 4 4 4 4 4 3 10 3 4 4 3 4 4 4 4 4 4 4 
4 4 4 4 4 4 4 3 4 4 4 4 4 4 1 1 4 4 4 4 4 4 4 4 4 4 4 4 4 4 2 4 4 4 4 4 4 4 4 4 4 3 3 3 3 3 3 3 3 1 3 4 4 3 3 3 3 3 3 3 3 3 3 3 3 3 3 1 3 4 4 4 4 4 4 3 1 3 1 3 1 3 4 4 4 4 4 3 1 3 4 4 3 4 4 4 4 4 4 4 
4 4 4 4 4 4 4 3 4 4 4 4 4 4 6 6 4 4 4 4 4 4 4 4 4 4 4 4 4 4 4 4 4 4 4 4 4 4 4 4 4 4 4 4 4 4 4 4 3 1 3 4 4 3 1 1 1 1 1 1 1 1 1 1 1 1 1 1 3 4 4 4 4 4 4 3 1 3 14 3 14 3 3 3 3 3 3 14 1 3 4 4 3 4 4 4 4 4 4 4 
4 4 4 4 4 4 4 3 4 4 4 4 4 4 1 1 4 4 4 4 4 4 4 4 4 4 4 4 4 4 4 4 4 4 4 4 4 4 4 4 4 4 4 4 4 4 4 4 3 1 3 4 4 3 1 3 3 3 3 3 3 3 3 3 3 3 3 3 3 4 4 4 4 4 4 3 5 5 5 5 5 5 5 5 5 5 5 1 1 3 4 4 3 4 4 4 4 4 4 4 
4 4 4 4 4 4 4 3 4 4 4 4 4 4 6 6 4 4 4 4 4 4 4 4 4 4 4 4 4 4 4 4 4 4 4 4 4 4 4 4 4 4 4 4 4 4 4 4 3 1 3 4 4 3 1 3 4 4 4 4 4 4 4 4 4 4 4 4 4 4 4 4 4 4 4 3 3 3 3 3 3 3 3 3 3 3 3 3 1 3 4 4 3 4 4 4 4 4 4 4 
4 4 4 4 4 4 4 3 4 4 4 4 4 4 1 1 4 4 4 4 4 4 4 4 4 4 4 4 4 4 4 4 4 4 4 4 4 4 4 4 4 4 4 4 4 4 4 4 3 1 3 4 4 3 1 3 4 4 4 4 4 4 4 4 4 4 4 4 4 4 4 4 4 4 4 4 4 4 4 4 4 4 4 4 4 4 4 3 1 3 4 4 3 4 4 4 4 4 4 4 
4 4 4 4 4 4 4 3 4 4 4 4 4 4 5 5 4 4 4 4 4 4 4 4 4 4 4 4 4 4 4 4 4 4 4 4 4 4 4 4 4 4 4 4 4 4 4 4 3 1 3 4 4 3 1 3 3 3 3 3 3 3 3 3 3 3 3 3 3 3 3 3 3 3 3 4 4 4 4 4 4 4 4 4 4 4 4 3 1 3 4 4 3 4 4 4 4 4 4 4 
4 4 4 4 4 4 4 3 4 4 4 4 4 4 1 1 4 4 4 4 4 4 4 4 4 4 4 4 4 4 4 3 3 3 3 3 3 3 3 3 3 3 3 3 4 4 4 4 3 1 3 4 4 3 1 1 1 1 1 1 1 1 1 1 1 1 1 1 1 1 1 1 1 1 3 4 4 4 4 4 4 4 4 4 4 4 4 3 1 3 4 4 3 4 4 4 4 4 4 4 
4 4 4 4 4 4 4 3 4 4 4 4 4 4 1 1 4 4 4 4 4 4 4 4 4 4 4 4 4 4 4 3 6 6 6 6 6 6 6 10 1 1 1 3 4 4 4 4 3 1 3 4 4 3 3 3 3 3 3 3 3 3 3 3 3 3 3 3 3 3 3 3 3 1 3 4 4 4 4 4 4 4 4 4 4 4 4 3 1 3 4 4 3 4 4 4 4 4 4 4 
4 4 4 4 4 4 4 3 4 3 1 1 1 1 1 1 1 1 1 1 1 1 3 4 4 4 4 4 4 3 3 3 6 3 3 3 3 3 3 3 3 3 1 3 4 4 4 4 3 1 3 4 4 4 4 4 4 4 4 4 4 4 4 4 4 4 4 4 4 4 4 4 3 1 3 4 4 4 4 4 4 4 4 4 4 4 4 3 1 3 4 4 3 4 4 4 4 4 4 4 
4 4 4 4 4 4 4 3 4 3 1 1 1 1 1 1 1 1 1 1 1 1 3 4 4 3 3 3 3 3 14 3 6 3 4 4 4 4 4 4 4 3 1 3 4 4 4 4 3 1 3 4 4 4 4 4 4 4 4 4 4 4 4 4 4 4 4 4 4 4 4 4 3 1 3 4 4 4 4 4 4 4 4 4 4 4 4 3 1 3 4 4 3 4 4 4 4 4 4 4 
4 4 4 4 4 4 4 3 4 3 1 1 3 4 4 4 4 4 4 3 1 1 3 4 4 3 1 1 1 1 1 1 1 5 5 5 3 4 4 4 4 3 1 3 4 4 4 4 3 1 3 4 4 4 4 4 4 4 4 4 4 4 4 4 4 4 4 4 4 4 4 4 3 1 3 4 4 4 4 4 4 4 4 4 4 4 4 3 1 3 4 4 3 4 4 4 4 4 4 4 
4 4 4 4 4 4 4 3 4 3 1 1 3 4 4 4 4 4 4 3 1 1 3 3 3 3 1 3 3 3 3 3 3 3 3 5 3 4 4 4 4 3 1 3 4 4 4 4 3 1 3 3 3 3 3 3 3 3 3 3 3 4 4 4 4 4 4 4 4 4 4 4 3 1 3 4 4 4 4 4 4 4 4 4 4 4 4 3 1 3 4 4 3 4 4 4 4 4 4 4 
4 4 4 4 4 4 4 3 4 3 1 1 3 4 4 4 4 4 4 3 1 1 1 1 1 1 1 3 4 4 4 4 4 4 3 5 3 4 4 4 4 3 1 3 4 4 4 4 3 1 10 1 1 1 1 1 1 1 1 8 3 4 4 4 4 4 4 4 4 4 4 4 3 1 3 4 4 4 4 4 4 4 4 4 4 4 4 3 1 3 4 4 3 4 4 4 4 4 4 4 
4 4 4 4 4 4 4 3 4 3 1 1 3 4 4 4 4 4 4 4 4 4 1 3 3 3 3 3 4 4 4 3 3 3 3 5 3 3 3 4 4 3 1 3 3 3 3 3 3 1 3 3 3 3 3 3 3 3 3 3 3 4 4 4 4 4 4 4 4 4 4 4 3 1 3 4 4 4 3 3 3 4 4 4 4 4 4 3 1 3 4 4 3 4 4 4 4 4 4 4 
4 4 4 4 4 4 4 3 4 3 1 1 3 3 3 4 4 4 4 4 4 4 6 4 4 4 4 4 4 4 4 3 0 0 0 0 0 0 3 4 4 3 1 1 1 1 1 1 1 1 3 4 4 4 4 4 4 4 4 4 4 4 4 4 4 4 4 3 3 3 3 3 3 1 3 4 4 4 3 11 3 4 4 4 4 4 4 3 1 3 4 4 3 4 4 4 4 4 4 4 
4 4 4 4 4 4 4 3 4 1 1 1 1 1 3 3 3 3 3 3 4 4 6 4 4 4 4 4 4 4 4 3 5 3 3 3 3 6 3 4 4 3 3 3 3 3 3 3 3 3 3 4 4 4 4 4 4 4 4 4 4 4 4 4 4 4 4 3 1 1 1 1 1 1 3 4 4 4 3 1 3 4 4 4 4 4 4 3 1 3 4 4 3 4 4 4 4 4 4 4 
4 4 4 4 4 4 4 3 4 1 4 4 1 1 1 1 1 1 1 3 4 4 6 4 4 4 4 4 4 4 4 3 0 3 11 0 3 0 3 4 4 4 4 4 4 4 4 4 4 4 4 4 4 4 4 4 4 4 4 4 4 4 4 4 4 4 4 3 1 3 3 3 3 1 3 4 4 4 3 1 3 4 4 4 4 4 4 3 1 3 4 4 3 4 4 4 4 4 4 4 
4 4 4 4 4 4 4 3 4 1 4 4 1 4 4 4 4 1 1 3 4 4 1 4 4 4 4 4 4 4 4 3 0 3 6 0 3 0 3 4 4 4 4 4 4 4 4 4 4 4 4 4 4 4 4 4 4 4 4 4 4 4 4 3 3 3 3 3 1 3 4 4 3 1 3 4 4 4 3 1 3 4 4 4 4 4 4 3 1 3 4 4 3 4 4 4 4 4 4 4 
4 4 4 4 4 4 4 3 4 1 4 4 12 4 4 4 4 1 1 3 4 4 1 1 1 1 5 4 0 4 4 3 6 3 6 3 3 5 3 4 4 4 4 4 4 4 4 4 4 4 4 4 4 4 4 4 4 4 4 4 4 4 4 3 1 1 1 1 1 3 4 4 3 1 3 4 4 4 3 1 3 4 4 4 4 4 4 3 1 3 4 4 3 4 4 4 4 4 4 4 
4 4 4 4 4 4 4 3 4 1 4 4 1 4 4 4 4 1 1 3 4 4 4 4 4 4 5 4 4 4 4 3 0 3 0 0 3 0 3 4 4 4 2 2 2 2 2 2 2 2 2 4 4 4 4 4 4 4 4 4 4 4 3 3 1 3 3 3 3 3 4 4 3 1 3 3 3 3 3 14 3 3 3 3 3 3 4 3 1 3 4 4 3 4 4 4 4 4 4 4 
4 4 4 4 4 4 4 3 4 8 12 1 9 1 5 5 1 1 13 3 4 4 4 4 4 4 5 4 4 4 4 3 0 3 3 0 3 0 3 4 4 4 4 4 4 4 4 4 4 4 2 4 4 4 4 4 4 4 3 3 3 3 3 1 1 3 4 4 4 4 4 4 3 1 1 1 1 1 1 1 1 1 1 1 9 3 4 3 1 3 4 4 3 4 4 4 4 4 4 4 
4 4 4 4 4 4 4 3 4 4 4 4 1 4 4 4 4 1 3 3 4 4 4 4 1 1 1 3 11 4 4 3 5 3 0 5 3 6 3 4 4 4 4 4 4 4 4 4 4 4 2 4 4 4 4 4 4 4 3 1 1 1 1 1 3 3 4 4 4 4 4 4 3 1 3 3 3 3 3 3 3 3 3 3 3 3 4 3 1 3 4 4 3 4 4 4 4 4 4 4 
4 4 4 4 4 4 4 3 4 4 4 4 1 12 6 6 1 1 3 4 4 4 4 4 1 1 3 1 1 4 4 3 0 3 0 3 3 0 3 4 4 4 4 4 4 4 4 4 4 4 2 4 4 4 4 4 4 4 3 1 3 3 3 3 3 4 4 4 4 4 4 4 3 1 3 4 4 4 4 4 4 4 4 4 4 4 4 3 1 3 4 4 3 4 4 4 4 4 4 4 
4 4 4 4 4 4 4 3 3 3 3 3 3 3 3 3 3 3 3 4 4 4 4 4 1 3 9 1 1 4 4 3 0 3 6 0 0 5 3 4 4 4 4 4 4 4 4 4 4 4 2 4 4 4 4 4 4 4 3 1 3 4 4 4 4 4 4 4 4 4 4 4 3 1 3 4 4 4 4 4 4 4 4 4 4 4 4 3 1 3 4 4 3 4 4 4 4 4 4 4 
4 4 4 4 4 4 4 3 4 4 4 4 4 4 4 4 4 4 4 4 4 4 4 4 1 1 1 1 1 4 4 3 6 3 3 3 3 0 3 4 4 4 4 4 4 4 4 4 4 4 2 4 4 4 4 4 4 4 3 1 3 4 4 4 4 4 4 4 4 4 4 4 3 1 3 4 4 4 4 4 4 4 4 4 4 4 4 3 1 3 4 4 3 4 4 4 4 4 4 4 
4 4 4 4 4 4 4 3 4 4 4 4 4 4 4 4 4 4 4 4 4 4 4 4 4 4 4 4 4 4 4 3 0 0 5 6 0 0 3 4 4 4 2 2 2 2 2 2 2 2 2 4 4 4 4 4 4 4 3 1 3 4 4 4 4 4 4 4 4 4 4 4 3 1 3 4 4 4 4 4 4 4 4 4 4 4 4 3 1 3 4 4 3 4 4 4 4 4 4 4 
4 4 4 4 4 4 4 3 4 4 4 4 4 4 4 4 4 4 4 4 4 4 4 4 4 4 4 4 4 4 4 3 3 3 3 3 3 3 3 4 4 4 2 4 4 4 4 4 4 4 4 4 4 4 4 4 4 4 3 1 3 4 4 4 4 4 4 4 4 4 4 4 3 1 3 4 4 4 4 4 4 4 4 4 4 4 4 3 1 3 4 4 3 4 4 4 4 4 4 4 
4 4 4 4 4 4 4 3 4 4 4 4 4 4 4 4 4 4 4 4 4 4 4 4 4 4 4 4 4 4 4 4 4 4 4 4 4 4 4 4 4 4 2 4 4 4 4 4 4 4 4 4 4 4 4 4 4 4 3 1 3 4 4 4 4 4 4 4 4 4 4 4 3 1 3 4 4 4 4 4 4 4 4 4 4 4 4 3 1 3 4 4 3 4 4 4 4 4 4 4 
4 4 4 4 4 4 4 3 4 4 4 4 4 4 4 4 4 4 4 4 4 4 4 4 4 4 4 4 4 4 4 4 4 4 4 4 4 4 4 4 4 4 2 4 4 4 4 4 4 4 4 4 4 4 4 4 4 4 3 1 3 4 4 4 4 4 4 4 4 4 4 4 3 1 3 4 4 4 4 4 4 4 4 4 4 4 4 3 1 3 4 4 3 4 4 4 4 4 4 4 
4 4 4 4 4 4 4 3 4 4 4 4 4 4 4 4 4 4 4 4 4 4 4 4 4 4 4 4 4 4 4 4 4 4 4 4 4 4 4 4 4 4 2 4 4 4 4 4 4 4 4 4 4 4 4 4 4 4 3 1 3 4 4 4 4 4 4 4 4 4 4 4 3 1 3 4 4 4 4 4 4 4 4 4 4 4 4 3 1 3 4 4 3 4 4 4 4 4 4 4 
4 4 4 4 4 4 4 3 4 4 4 4 4 4 4 4 4 4 4 4 4 4 4 4 4 4 4 4 4 4 4 4 4 4 4 4 4 4 4 4 4 4 2 4 4 4 4 4 4 4 4 4 4 4 4 4 4 4 3 1 3 4 4 4 4 4 4 4 4 4 4 4 3 1 3 4 4 4 4 4 4 4 4 4 4 4 4 3 1 3 4 4 3 4 4 4 4 4 4 4 
4 4 4 4 4 4 4 3 4 4 4 4 4 4 4 4 4 4 4 4 4 4 4 4 4 4 4 4 4 4 4 4 4 4 4 4 4 4 4 4 4 4 2 2 2 2 2 2 2 2 2 4 4 4 4 4 4 4 3 1 3 3 3 3 3 3 3 3 3 3 3 3 3 3 3 3 3 3 3 3 3 3 3 3 3 3 3 3 1 3 4 4 3 4 4 4 4 4 4 4 
4 4 4 4 4 4 4 3 4 4 4 4 4 4 4 4 4 4 4 4 4 4 4 4 4 4 4 4 4 4 4 4 4 4 4 4 4 4 4 4 4 4 4 4 4 4 4 4 4 4 4 4 4 4 4 4 4 4 3 1 1 1 1 1 1 1 1 1 1 1 1 1 1 1 1 1 1 1 1 1 1 1 1 1 1 1 1 1 1 3 4 4 3 4 4 4 4 4 4 4 
4 4 4 4 4 4 4 3 4 4 4 4 4 4 4 4 4 4 4 4 4 4 4 4 4 4 4 4 4 4 4 4 4 4 4 4 4 4 4 4 4 4 4 4 4 4 4 4 4 4 4 4 4 4 4 4 4 4 3 3 3 3 3 3 3 3 3 3 3 3 3 3 3 3 3 3 3 3 3 3 3 3 3 3 3 3 3 3 3 3 4 4 3 4 4 4 4 4 4 4 
4 4 4 4 4 4 4 3 4 4 4 4 4 4 4 4 4 4 4 4 4 4 4 4 4 4 4 4 4 4 4 4 4 4 4 4 4 4 4 4 4 4 4 4 4 4 4 4 4 4 4 4 4 4 4 4 4 4 4 4 4 4 4 4 4 4 4 4 4 4 4 4 4 4 4 4 4 4 4 4 4 4 4 4 4 4 4 4 4 4 4 4 3 4 4 4 4 4 4 4 
4 4 4 4 4 4 4 3 4 4 4 4 4 4 4 4 4 4 4 4 4 4 4 4 4 4 4 4 4 4 4 4 4 4 4 4 4 4 4 4 4 4 4 4 4 4 4 4 4 4 4 4 4 4 4 4 4 4 4 4 4 4 4 4 4 4 4 4 4 4 4 4 4 4 4 4 4 4 4 4 4 4 4 4 4 4 4 4 4 4 4 4 3 4 4 4 4 4 4 4 
4 4 4 4 4 4 4 3 3 3 3 3 3 3 3 3 3 3 3 3 3 3 3 3 3 3 3 3 3 3 3 3 3 3 3 3 3 3 3 3 3 3 3 3 3 3 3 3 3 3 3 3 3 3 3 3 3 3 3 3 3 3 3 3 3 3 3 3 3 3 3 3 3 3 3 3 3 3 3 3 3 3 3 3 3 3 3 3 3 3 3 3 3 4 4 4 4 4 4 4 
4 4 4 4 4 4 4 3 4 4 4 4 4 4 4 4 4 4 4 4 4 4 4 4 4 4 4 4 4 4 4 4 4 4 4 4 4 4 4 4 4 4 4 4 4 4 4 4 4 4 4 4 4 4 4 4 4 4 4 4 4 4 4 4 4 4 4 4 4 4 4 4 4 4 4 4 4 4 4 4 4 4 4 4 4 4 4 4 4 4 4 4 3 4 4 4 4 4 4 4 
4 4 4 4 4 4 4 3 4 4 4 4 4 4 4 4 4 4 4 4 4 4 4 4 4 4 4 4 4 4 4 4 4 4 4 4 4 4 4 4 4 4 4 4 4 4 4 4 4 4 4 4 4 4 4 4 4 4 4 4 4 4 4 4 4 4 4 4 4 4 4 4 4 4 4 4 4 4 4 4 4 4 4 4 4 4 4 4 4 4 4 4 3 4 4 4 4 4 4 4 
4 4 4 4 4 4 4 3 4 3 1 1 1 1 1 1 1 1 3 3 4 4 4 4 4 4 4 4 4 4 4 4 4 4 4 4 4 4 4 4 4 4 4 4 4 4 4 4 4 4 4 4 4 4 4 4 4 4 4 4 4 4 4 4 4 4 4 4 4 4 4 4 4 4 4 4 4 4 4 4 4 4 4 4 4 4 4 4 4 4 4 4 3 4 4 4 4 4 4 4 
4 4 4 4 4 4 4 3 4 1 1 1 1 1 1 1 1 1 1 1 4 4 4 4 4 4 4 4 4 4 4 4 4 4 4 4 4 4 4 4 4 4 4 4 4 4 4 4 4 4 4 4 4 4 4 4 4 4 4 4 4 4 4 4 4 4 4 4 4 4 4 4 4 4 4 4 4 4 4 4 4 4 4 4 4 4 4 4 4 4 4 4 3 4 4 4 4 4 4 4 
4 4 4 4 4 4 4 3 4 1 1 1 6 1 1 1 6 1 1 1 4 4 4 4 4 4 4 4 4 4 4 4 4 4 4 4 4 4 4 3 3 3 3 3 3 3 3 3 3 3 4 4 4 4 4 4 4 4 4 4 4 4 4 4 4 4 4 4 4 4 4 4 4 4 4 4 4 4 4 4 4 4 4 4 4 4 4 4 4 4 4 4 3 4 4 4 4 4 4 4 
4 4 4 4 4 4 4 3 4 1 1 6 1 6 1 6 1 6 1 1 4 4 4 4 4 4 4 4 4 4 4 4 4 4 4 4 4 4 4 3 1 1 1 1 1 1 1 1 1 3 3 3 3 3 3 3 3 3 3 4 4 4 4 4 4 4 3 3 3 3 3 3 3 3 3 4 4 4 4 3 3 3 3 3 3 4 4 4 4 4 4 4 3 4 4 4 4 4 4 4 
4 4 4 4 4 4 4 3 4 1 6 1 1 1 6 1 1 1 6 1 4 4 4 4 4 4 4 4 4 4 4 4 4 4 4 4 4 4 4 3 1 1 1 1 2 1 1 1 1 1 6 6 1 5 1 1 1 1 3 4 4 3 3 3 3 3 3 1 1 1 6 1 1 1 3 4 4 4 4 3 1 1 6 1 3 4 4 4 4 4 4 4 3 4 4 4 4 4 4 4 
4 4 4 4 4 4 4 3 4 1 1 6 1 1 1 1 1 6 1 1 4 4 4 4 4 4 4 4 4 4 4 4 4 4 4 4 4 4 4 3 1 1 1 2 2 1 1 1 1 3 3 3 3 3 3 3 3 6 3 4 3 3 1 6 1 1 3 1 5 3 3 3 3 6 3 4 4 4 4 3 1 3 3 6 3 3 3 3 3 3 3 4 3 4 4 4 4 4 4 4 
4 4 4 4 4 4 4 3 4 1 1 1 6 1 1 1 6 1 1 1 4 4 4 4 4 4 4 4 4 4 4 4 4 4 4 4 4 4 4 3 1 1 1 1 13 1 1 1 1 3 4 4 3 6 1 5 1 1 3 4 3 1 1 3 3 1 3 3 1 3 4 4 3 1 3 4 3 3 3 3 5 3 3 6 1 5 1 1 1 1 3 4 3 4 4 4 4 4 4 4 
4 4 4 4 4 4 4 3 4 1 1 1 1 6 1 6 1 1 1 1 4 4 4 4 4 4 4 4 4 4 4 4 4 4 4 4 4 4 4 3 1 1 1 1 2 1 1 1 1 3 4 4 3 6 3 3 3 3 3 3 3 5 3 3 3 5 3 3 1 3 4 3 1 5 3 3 3 1 5 1 1 3 3 3 3 3 3 3 3 1 3 4 3 4 4 4 4 4 4 4 
4 4 4 4 4 4 4 3 4 3 1 1 1 1 6 1 1 1 1 3 4 4 4 4 4 4 4 4 4 4 4 4 4 4 4 4 4 4 4 3 1 1 1 2 2 2 1 1 1 3 4 4 3 1 6 1 13 1 5 1 1 1 3 4 3 1 6 1 6 3 4 3 6 1 1 6 1 1 3 3 3 3 4 4 4 4 4 4 4 1 3 4 3 4 4 4 4 4 4 4 
4 4 4 4 4 4 4 3 4 3 3 3 3 3 6 3 3 3 3 3 4 4 4 4 4 4 4 4 4 4 4 4 4 4 4 4 4 4 4 3 1 1 1 1 1 1 1 1 1 3 4 4 3 3 3 3 3 3 3 3 3 3 3 4 3 3 3 3 3 3 4 3 3 3 3 3 3 3 3 4 4 4 4 4 4 1 1 1 1 1 3 4 3 4 4 4 4 4 4 4 
4 4 4 4 4 4 4 3 4 4 4 4 4 3 6 3 4 4 4 4 4 4 4 4 4 4 4 4 4 4 4 4 4 4 4 4 4 4 4 3 3 3 3 3 3 3 3 3 3 3 4 4 4 4 4 4 4 4 4 4 4 4 4 4 4 4 4 4 4 4 4 4 4 4 4 4 4 4 4 4 4 4 4 4 4 1 3 3 3 3 3 4 3 4 4 4 4 4 4 4 
4 4 4 4 4 4 4 3 4 4 4 4 4 3 6 3 4 4 4 4 4 4 4 4 4 4 4 4 4 4 4 4 4 4 4 4 4 4 4 3 3 3 3 3 3 3 3 3 3 3 4 4 4 4 4 4 4 4 4 4 4 4 4 4 4 4 4 4 4 4 4 4 4 4 4 4 4 4 4 4 4 15 1 1 1 1 3 3 3 3 3 4 3 4 4 4 4 4 4 4 
4 4 4 4 4 4 4 3 4 4 4 4 4 3 6 3 4 4 4 4 4 4 4 4 4 4 4 4 4 4 4 4 4 4 4 4 4 4 4 3 1 1 1 1 1 1 1 1 1 3 4 4 4 4 4 4 4 4 4 4 4 4 4 4 4 4 4 4 4 4 4 4 4 4 4 4 4 4 4 4 4 4 4 4 4 1 1 1 1 1 3 4 3 4 4 4 4 4 4 4 
4 4 4 4 4 4 4 3 4 4 4 4 4 3 6 3 4 4 4 4 4 4 4 4 4 4 4 4 4 4 4 4 4 4 4 4 4 4 4 3 1 1 1 2 2 2 1 1 1 3 4 4 4 4 4 4 4 4 4 4 4 4 4 4 4 4 4 4 4 4 4 4 4 4 4 4 4 4 4 4 4 4 4 4 4 4 4 4 4 1 3 4 3 4 4 4 4 4 4 4 
4 4 4 4 4 4 4 3 4 4 4 4 4 3 6 3 4 4 4 4 4 4 4 4 4 4 4 4 4 4 4 4 4 4 4 4 4 4 4 3 1 1 1 1 1 2 1 1 1 3 3 3 3 3 3 3 3 3 3 3 3 3 3 3 3 3 3 3 3 3 3 3 3 3 3 3 3 3 3 3 3 3 3 3 3 3 3 3 3 1 3 4 3 4 4 4 4 4 4 4 
4 4 4 4 4 4 4 3 4 4 4 4 4 3 6 3 4 4 4 4 4 4 4 4 4 4 4 4 4 4 4 4 4 4 4 4 4 4 4 3 1 1 1 2 13 2 1 1 1 1 1 1 1 14 1 1 1 1 14 1 1 1 1 14 1 1 1 1 1 1 1 1 1 1 1 1 1 1 1 1 1 1 1 1 1 1 1 1 1 1 3 4 3 4 4 4 4 4 4 4 
4 4 4 4 4 4 4 3 4 4 4 4 4 3 6 3 4 4 4 4 4 4 4 4 4 4 4 4 4 4 4 4 4 4 4 4 4 4 4 3 1 1 1 2 1 1 1 1 1 3 3 3 3 3 3 3 3 1 4 4 4 4 4 4 4 4 4 4 4 4 4 4 4 4 4 4 4 4 4 4 4 4 4 4 4 4 4 4 4 1 3 4 3 4 4 4 4 4 4 4 
4 4 4 4 4 4 4 3 4 4 4 4 4 3 6 3 4 4 4 4 4 4 4 4 4 4 4 4 4 4 4 4 4 4 4 4 4 4 4 3 1 1 1 2 2 2 1 1 1 3 4 4 4 4 4 4 3 1 4 4 4 4 4 4 4 4 4 4 4 4 4 4 4 4 4 4 4 4 4 4 4 4 4 4 4 4 4 4 4 1 3 4 3 4 4 4 4 4 4 4 
4 4 4 4 4 4 4 3 4 4 4 4 4 3 6 3 4 4 4 4 4 4 4 4 4 4 4 4 4 4 4 4 4 4 4 4 4 4 4 3 1 1 1 1 1 1 1 1 1 3 4 4 4 4 4 4 3 1 1 14 1 1 14 1 1 13 1 14 1 1 13 1 14 1 1 1 1 1 1 1 1 1 1 1 1 1 1 1 1 1 3 4 3 4 4 4 4 4 4 4 
4 4 4 4 4 4 4 3 4 4 4 4 4 3 6 3 4 4 4 4 4 4 4 4 4 4 4 4 4 4 4 4 4 4 4 4 4 4 4 3 3 3 3 3 3 3 3 3 3 3 4 4 4 4 4 4 3 3 3 3 3 3 3 3 3 3 3 3 3 3 3 3 3 3 3 3 3 3 3 3 3 3 3 3 3 3 3 3 3 3 3 4 3 4 4 4 4 4 4 4 
4 4 4 4 4 4 4 3 4 4 4 4 4 3 6 3 4 4 4 4 4 4 4 4 4 4 4 3 3 3 3 3 3 3 3 3 4 4 4 3 3 3 3 3 3 3 3 3 3 3 4 4 4 4 4 4 4 4 4 4 4 4 4 4 4 4 4 4 4 4 4 4 4 4 4 4 4 4 4 4 4 4 4 4 4 4 4 4 4 4 4 4 3 4 4 4 4 4 4 4 
4 4 4 4 4 4 4 3 4 4 4 4 4 3 6 3 4 4 4 4 4 4 4 4 4 4 4 3 1 1 1 1 1 1 1 3 4 4 4 3 1 1 1 1 1 1 1 1 1 3 4 4 4 4 4 4 4 4 4 4 4 4 4 4 4 4 4 4 4 4 4 4 4 4 4 4 4 4 4 4 4 4 4 4 4 4 4 4 4 4 4 4 3 4 4 4 4 4 4 4 
4 4 4 4 4 4 4 3 4 4 4 4 4 3 6 3 4 4 4 4 4 4 4 4 4 4 4 3 1 1 1 1 1 1 1 3 4 4 4 3 1 1 1 2 2 2 1 1 1 3 4 4 4 4 4 4 4 4 4 4 4 4 4 4 4 4 4 4 4 4 4 4 4 4 4 4 4 4 4 4 4 4 4 4 4 4 4 4 4 4 4 4 3 4 4 4 4 4 4 4 
4 4 4 4 4 4 4 3 4 4 4 4 4 3 6 3 4 4 4 4 4 4 4 4 4 4 4 3 1 12 1 12 1 12 1 3 4 4 4 3 1 1 1 1 1 2 1 1 1 3 3 3 3 3 3 3 3 3 3 3 3 3 3 3 3 3 3 3 3 4 4 4 4 4 4 4 4 4 4 4 4 4 4 4 4 4 4 4 4 4 4 4 3 4 4 4 4 4 4 4 
4 4 4 4 4 4 4 3 4 4 4 3 3 3 6 3 3 3 3 3 4 4 4 4 4 4 4 3 1 1 1 1 1 1 1 3 4 4 4 3 1 1 1 2 13 2 1 1 1 1 1 1 1 1 1 1 1 1 1 1 1 1 1 1 1 1 1 1 3 4 4 4 4 4 4 4 4 4 4 4 4 4 4 4 4 4 4 4 4 4 4 4 3 4 4 4 4 4 4 4 
4 4 4 4 4 4 4 3 4 4 4 3 1 1 1 1 1 1 1 3 4 4 4 4 4 4 4 3 1 1 1 1 1 1 1 3 4 4 4 3 1 1 1 1 1 2 1 1 1 3 3 3 3 3 3 3 3 1 3 3 3 3 1 3 3 3 3 1 3 4 4 4 4 4 4 4 4 4 4 4 4 4 4 4 4 4 4 4 4 4 4 4 3 4 4 4 4 4 4 4 
4 4 4 4 4 4 4 3 4 4 4 3 3 3 5 3 6 3 3 3 4 4 4 4 4 4 4 3 1 1 1 1 1 1 1 3 4 4 4 3 1 1 1 2 2 2 1 1 1 3 4 4 4 4 4 4 3 12 3 4 4 3 12 3 4 4 3 12 3 4 4 4 4 4 4 4 4 4 4 4 4 4 4 4 4 4 4 4 4 4 4 4 3 4 4 4 4 4 4 4 
4 4 4 4 4 4 4 3 4 4 4 3 5 5 5 3 6 6 6 3 4 4 4 4 4 4 4 3 1 1 1 1 1 1 1 3 4 4 4 3 1 1 1 1 1 1 1 1 1 3 4 4 4 4 4 4 3 3 3 4 4 3 3 3 4 4 3 3 3 4 4 4 4 4 4 4 4 4 4 4 4 4 4 4 4 4 4 4 4 4 4 4 3 4 4 4 4 4 4 4 
4 4 4 4 4 4 4 3 4 4 4 3 5 5 5 3 6 6 6 3 4 4 4 4 4 4 4 3 3 3 14 3 14 3 3 3 4 4 4 3 3 3 3 3 3 3 3 3 3 3 4 4 4 4 4 4 4 4 4 4 4 4 4 4 4 4 4 4 4 4 4 4 4 4 4 4 4 4 4 4 4 4 4 4 4 4 4 4 4 4 4 4 3 4 4 4 4 4 4 4 
4 4 4 4 4 4 4 3 4 4 4 3 5 5 5 3 6 6 6 3 4 4 4 4 4 4 4 4 4 3 6 3 5 3 4 4 4 4 4 4 4 4 4 4 4 4 4 4 4 4 4 4 4 4 4 4 4 4 4 4 4 4 4 4 4 4 4 4 4 4 4 4 4 4 4 4 4 4 4 4 4 4 4 4 4 4 4 4 4 4 4 4 3 4 4 4 4 4 4 4 
4 4 4 4 4 4 4 3 4 4 4 3 5 5 5 3 6 6 6 3 4 4 4 4 4 4 4 4 4 3 6 3 5 3 4 4 4 4 4 4 4 4 4 4 4 4 4 4 4 4 4 4 4 4 4 4 4 4 4 4 4 4 4 4 4 4 4 4 4 4 4 4 4 4 4 4 4 4 4 4 4 4 4 4 4 4 4 4 4 4 4 4 3 4 4 4 4 4 4 4 
4 4 4 4 4 4 4 3 4 4 4 3 5 5 3 4 3 6 6 3 4 4 4 4 4 4 4 4 4 3 6 3 5 3 4 4 4 4 4 4 4 4 4 4 4 4 4 4 4 4 4 4 4 4 4 4 4 4 4 4 4 4 4 4 4 4 4 4 4 4 4 4 4 4 4 4 4 4 4 4 4 4 4 4 4 4 4 4 4 4 4 4 3 4 4 4 4 4 4 4 
4 4 4 4 4 4 4 3 4 4 4 3 3 5 3 4 3 6 3 3 4 4 4 4 4 4 4 4 4 3 6 3 5 3 4 4 4 4 4 4 4 4 4 4 4 4 4 4 4 4 4 4 4 4 4 4 4 4 4 4 4 4 4 4 4 4 4 4 4 4 4 4 4 4 4 4 4 4 4 4 4 4 4 4 4 4 4 4 4 4 4 4 3 4 4 4 4 4 4 4 
4 4 4 4 4 4 4 3 4 4 4 4 3 5 3 4 3 6 3 3 3 3 3 3 3 3 3 3 3 3 6 3 5 3 4 4 4 4 4 4 4 4 4 4 4 4 4 4 4 4 4 4 4 4 4 4 4 4 4 4 4 4 4 4 4 4 4 4 4 4 4 4 4 4 4 4 4 4 4 4 4 4 4 4 4 4 4 4 4 4 4 4 3 4 4 4 4 4 4 4 
4 4 4 4 4 4 4 3 4 4 4 4 4 5 3 4 3 6 6 6 6 6 6 6 6 6 6 6 6 6 6 3 5 3 4 4 4 4 4 4 4 4 4 4 4 4 4 4 4 4 4 4 4 4 4 4 4 4 4 4 4 4 4 4 4 4 4 4 4 4 4 4 4 4 4 4 4 4 4 4 4 4 4 4 4 4 4 4 4 4 4 4 3 4 4 4 4 4 4 4 
4 4 4 4 4 4 4 3 4 4 4 4 4 5 3 3 3 3 3 3 3 3 3 3 3 3 3 3 3 3 3 3 5 3 4 4 4 4 4 4 4 4 4 4 4 4 4 4 4 4 4 4 4 4 4 4 4 4 4 4 4 4 4 4 4 4 4 4 4 4 4 4 4 4 4 4 4 4 4 4 4 4 4 4 4 4 4 4 4 4 4 4 3 4 4 4 4 4 4 4 
4 4 4 4 4 4 4 3 4 4 4 4 4 5 5 5 5 5 5 5 5 5 5 5 5 5 5 5 5 5 5 5 5 3 4 4 4 4 4 4 4 4 4 4 4 4 4 4 4 4 4 4 4 4 4 4 4 4 4 4 4 4 4 4 4 4 4 4 4 4 4 4 4 4 4 4 4 4 4 4 4 4 4 4 4 4 4 4 4 4 4 4 3 4 4 4 4 4 4 4 
4 4 4 4 4 4 4 3 4 4 4 4 4 4 4 4 4 4 4 4 4 4 4 4 4 4 4 4 4 4 4 4 4 4 4 4 4 4 4 4 4 4 4 4 4 4 4 4 4 4 4 4 4 4 4 4 4 4 4 4 4 4 4 4 4 4 4 4 4 4 4 4 4 4 4 4 4 4 4 4 4 4 4 4 4 4 4 4 4 4 4 4 3 4 4 4 4 4 4 4 
4 4 4 4 4 4 4 3 3 3 3 3 3 3 3 3 3 3 3 3 3 3 3 3 3 3 3 3 3 3 3 3 3 3 3 3 3 3 3 3 3 3 3 3 3 3 3 3 3 3 3 3 3 3 3 3 3 3 3 3 3 3 3 3 3 3 3 3 3 3 3 3 3 3 3 3 3 3 3 3 3 3 3 3 3 3 3 3 3 3 3 3 3 4 4 4 4 4 4 4 
4 4 4 4 4 4 4 4 4 4 4 4 4 4 4 4 4 4 4 4 4 4 4 4 4 4 4 4 4 4 4 4 4 4 4 4 4 4 4 4 4 4 4 4 4 4 4 4 4 4 4 4 4 4 4 4 4 4 4 4 4 4 4 4 4 4 4 4 4 4 4 4 4 4 4 4 4 4 4 4 4 4 4 4 4 4 4 4 4 4 4 4 4 4 4 4 4 4 4 4 
4 4 4 4 4 4 4 4 4 4 4 4 4 4 4 4 4 4 4 4 4 4 4 4 4 4 4 4 4 4 4 4 4 4 4 4 4 4 4 4 4 4 4 4 4 4 4 4 4 4 4 4 4 4 4 4 4 4 4 4 4 4 4 4 4 4 4 4 4 4 4 4 4 4 4 4 4 4 4 4 4 4 4 4 4 4 4 4 4 4 4 4 4 4 4 4 4 4 4 4 
4 4 4 4 4 4 4 4 4 4 4 4 4 4 4 4 4 4 4 4 4 4 4 4 4 4 4 4 4 4 4 4 4 4 4 4 4 4 4 4 4 4 4 4 4 4 4 4 4 4 4 4 4 4 4 4 4 4 4 4 4 4 4 4 4 4 4 4 4 4 4 4 4 4 4 4 4 4 4 4 4 4 4 4 4 4 4 4 4 4 4 4 4 4 4 4 4 4 4 4 
4 4 4 4 4 4 4 4 4 4 4 4 4 4 4 4 4 4 4 4 4 4 4 4 4 4 4 4 4 4 4 4 4 4 4 4 4 4 4 4 4 4 4 4 4 4 4 4 4 4 4 4 4 4 4 4 4 4 4 4 4 4 4 4 4 4 4 4 4 4 4 4 4 4 4 4 4 4 4 4 4 4 4 4 4 4 4 4 4 4 4 4 4 4 4 4 4 4 4 4 
4 4 4 4 4 4 4 4 4 4 4 4 4 4 4 4 4 4 4 4 4 4 4 4 4 4 4 4 4 4 4 4 4 4 4 4 4 4 4 4 4 4 4 4 4 4 4 4 4 4 4 4 4 4 4 4 4 4 4 4 4 4 4 4 4 4 4 4 4 4 4 4 4 4 4 4 4 4 4 4 4 4 4 4 4 4 4 4 4 4 4 4 4 4 4 4 4 4 4 4 
